############
#          #
#   P XO   #
#          #
### X      #
#   O      #
#          #
#          #
#          #
#          #
############
